101010101
110000011  
110010011
010111010
111111111
000000000
000000000
000000000
000000000