111111111
011000110
111111111
011111110
000111000
000000000
000000000
000000000
000000000