010010010
010010010
010010010
011101110
110010011
010010010
001111100
000111000
000000000