101010101
000000000
111111111
000000000
000000000
000000000
000000000
000000000
000000000