111111111
000000000
010101010
100101001
100010001
111111111
000000000
000000000
000000000