101000101
010000010
000101000
010101010
101010101
000000000
000000000
000000000
000000000