101010101
110000011  
100010001
010000010
100000001
000000000
000000000
000000000
000000000