101010101
110000011  
110010011
010000010
100000001
111111111
000000000
000000000
000000000