101010101
110000011
110010011
111111111
111111111
111111111
111111111
111111111
111111111