111111111
110101011
110000011
101000101
100000001
000000000
000000000
000000000
000000000