101010101
000000000
010101010
000000000
001010100
000000000
000000000
000000000
000000000