000010000
011111110
000010000
111101111
001010100
000000000
000000000
000000000
000000000