000000000
010010010
111111111
010000010
110010011
001101100
000000000
000000000
000000000